H##I####S#H
#*********#
H*###*S##*S
#*#B#*###*#
H*********H
#*#S#*#I#*#
H*###*###*H
#*********#
H#H##S##H#H