H##I####$#H
#*********#
H*###*$##*$
#*#B#*###*#
H*********H
#*#$#*#I#*#
H*###*###*H
#*********#
H#H##$##H#H